RRRRRRRRRRRRRRRRRRRRRRRRRRRRRRRRRR
R....@...........................R
R................................R
R................................R
R................................R
R................................R
R................................R
R................................R
R................................R
R................................R
R................................R
RRRRRRRRRRRRRRRRRRRRRRRRRRRRRRRRRR