RRRRRRRRRRRRRRRRRRRRRRRRRRRRRRRRRRRRRRRR
R....@.................................R
R......................................R
R......................................R
R......................................R
R......................................R
R......................................R
R......................................R
R......................................R
R......................................R
R......................................R
R......................................R
R......................................R
R......................................R
R......................................R
R......................................R
R......................................R
R......................................R
R......................................R
R......................................R
R......................................R
RRRRRRRRRRRRRRRRRRRRRRRRRRRRRRRRRRRRRRRR